



11111111111111111111111111111
10000000000000W00000000000001
100000P000000000C000000000001
10W00000000000000000000000001
1000000C00000000W0000000000E1
11111111111111111111111111111


