




111111111111111111111111111111111111111111111111111111111
100000000000000000000000000011111111111111111111111111111
100000P000000000C0000000000011111111111111111111111111111
100000000000000000000000000011111111111111111111111111111
1000000C0000000000000000000E11111111111111111111111111111
111111111111111111111111111111111111111111111111111111111


